35
8
22 22 22 22 22 22 22 22 22 22 22 22 22 22 22 22 22 22 22 22 22 22 22 22 22 22 22 22 22 22 22 22 22 22 22 
22 0 0 0 0 0 0 0 0 0 0 0 0 0 0 0 0 0 0 0 0 0 0 0 0 0 0 0 0 0 0 0 0 0 22 
22 0 0 0 0 0 0 0 0 0 0 0 0 0 0 0 0 0 0 0 0 0 0 0 0 0 0 0 0 0 0 0 0 0 22 
22 0 0 0 0 0 0 0 0 0 0 0 0 0 0 0 0 0 0 0 0 0 0 0 0 0 0 0 0 0 0 0 0 0 22 
22 0 12 0 0 0 0 0 0 13 0 0 21 0 14 0 23 21 21 0 0 0 0 0 0 0 0 0 0 0 16 0 0 0 22 
22 0 0 0 0 0 0 0 0 0 0 21 22 0 0 0 0 22 22 0 15 0 0 0 0 0 0 21 0 0 0 0 0 0 22 
22 21 21 21 21 21 21 21 21 21 21 22 22 0 0 0 0 22 22 0 0 0 21 21 0 0 0 22 21 21 21 21 21 21 22 
22 22 22 22 22 22 22 22 22 22 22 22 22 22 22 22 22 22 22 22 22 22 22 22 22 22 22 22 22 22 22 22 22 22 22 
